8 8 3.5 3.5 0
 _ _ _ _ _ _ _ _ 
|      _ _ _ _  |
| | | |  _ _ _| |
| | |_|  _ _  |_|
| | |  _|  _|_ _ 
|_| | | | |_ _  |
|  _| | |_ _  | |
| |_ _     _ _| |
|_ _ _ _ _ _ _ _|