39 5
# #  #  ##       ## ### #   ###  ## ###
### # # # #     #   #   #   #   #    # 
### ### ##       #  ##  #   ##  #    # 
# # # # #         # #   #   #   #    # 
# # # # #       ##  ### ### ###  ##  # 